┌────────────┬───────┐
│ risk_level │   n   │
│  varchar   │ int64 │
├────────────┼───────┤
│ Low        │  1615 │
│ High       │    85 │
└────────────┴───────┘
